X,,,,,,,
,X,,,,,,
,,X,,,,,
,,,X,,,,
,,,,X,,,
,,,,,X,,
,,,,,,,
X,X,X,X,X,X,X,R
